Aberdare Teacher's Training College	r.aberdare-ttc.m.kenet.or.ke
ACORN BUSINES SERVICES LTD -QWETU Juja	r.qwetu-juja.n.kenet.or.ke
ACORN BUSINES SERVICES LTD-QWETU Chiromo	r.qwetu-chiromo.n.kenet.or.ke
ACORN BUSINES SERVICES LTD-QWETU Hulingam	r.qwetu-hurlingham.n.kenet.or.ke
ACORN BUSINES SERVICES LTD-QWETU Parklands	r.qwetu-parklands.n.kenet.or.ke
Adventist University of Africa	r.aua.n.kenet.or.ke
AIC Kijabe Ma Mahiu	r.aic-kijabe-maimahiu.a.kenet.or.ke
AIC Kijabe Marira	r.aic-kijabe-marira.n.kenet.or.ke
AIC Kijabe Nairobi	r.aic-kijabe-nrb.n.kenet.or.ke
AKU Diagnostics	r.aku-diagnostics.n.kenet.or.ke
AKU Main	r.aku-main.n.kenet.or.ke
Ampath ACTG	r.ampath-actg.e.kenet.or.ke
Ampath Daima Towers	r.ampath-daimatowers.e.kenet.or.ke
AMPATH-Bungoma - Dumisha Afya	r.ampath-bungoma.e.kenet.or.ke
ANU Main	r.anu-main.n.kenet.or.ke
Asumbi TTC	r.asumbi-ttc.k.kenet.or.ke
BOMA College	r.boma-college.n.kenet.or.ke
Bomet University College	r.bomet.a.kenet.or.ke
Bondo TTC	r.bondo-ttc.k.kenet.or.ke
Borabu Teachers Training College	r.borabu-ttc.k.kenet.or.ke
Bukura Agricultural College	r.bukura.k.kenet.or.ke
Bungoma North Technical and Vocational College	r.bungoma-north-tvc.e.kenet.or.ke
Bureti Technical Training Institute	r.bureti-tti.a.kenet.or.ke
Bushiangala Technical training Institute	r.bushiangala-tti.k.kenet.or.ke
Butere Technical and Vocational College	r.butere-tvc.k.kenet.or.ke
Carlile College	r.carlile-college.n.kenet.or.ke
Catholic University of Eastern Africa - Eldoret	r.cuea-eld.e.kenet.or.ke
Catholic University of Eastern Africa - Main	r.cuea-main.n.kenet.or.ke
Centre for Mathematics, Science and Technology Education in Africa - CEMASTEA	r.cemastea.n.kenet.or.ke
Chamasiri Technical and Vocational college	r.chamasiri-tvc.k.kenet.or.ke
Christian Industrial Training Centres	r.citc.n.kenet.or.ke
Chuka Chogoria	r.chuka-chogoria.m.kenet.or.ke
Chuka Embu	r.chuka-embu.m.kenet.or.ke
Chuka Igembe	r.chuka-igembe.m.kenet.or.ke
Chuka Nairobi	r.chuka-nrb.n.kenet.or.ke
Chuka University	r.chuka.m.kenet.or.ke
Coast Institute of Technology	r.coast-inst.s.kenet.or.ke
Coast Institute of Technology Town	r.coast-inst-town.s.kenet.or.ke
Council for Legal Education	r.cle.n.kenet.or.ke
David Mbiti Wambuli TVC	r.david-mbiti-tvc.n.kenet.or.ke
Daystar University - Athi River	r.days-athi.n.kenet.or.ke
Daystar University - Nairobi	r.days-nrb.n.kenet.or.ke
Dedan KImathi University of Science and Technology	r.kimathi-main.m.kenet.or.ke
Defense Staff College Karen	r.defence-staff-karen.n.kenet.or.ke
East Africa School of Aviation	r.easa.n.kenet.or.ke
Egerton Bontana Campus	r.eger-bontana.a.kenet.or.ke
Egerton University - CHS	r.eger-health.a.kenet.or.ke
Egerton University - Town Campus	r.eger-town.a.kenet.or.ke
Egerton University, Njoro campus	r.eger-njoro.a.kenet.or.ke
Embu Level 5 Hospital	r.embu-level5.m.kenet.or.ke
Embu University	r.embuni.m.kenet.or.ke
Eregi Teachers Training College	r.eregi-ttc.k.kenet.or.ke
Friends College Kaimosi	r.friends-college.k.kenet.or.ke
Garissa University	r.garissa.n.kenet.or.ke
Gatundu South Technical and Vocational College	r.gatundu-tvc.n.kenet.or.ke
GRETSA	r.gretsa-main.n.kenet.or.ke
Hekima College-IPSIR	r.hekima-ipsir.n.kenet.or.ke
Hekima College-JST	r.hekima-jst.n.kenet.or.ke
Henry Jackson Foundation Medical Research International - HJFMRI - Kisumu  Office	r.hjfmri-ksm.k.kenet.or.ke
Higher Education Loans Board - HELB Main	r.helb.n.kenet.or.ke
International Centre of Insect Physiology and Ecology - ICIPE	r.icipe.n.kenet.or.ke
International Livestock Research Institute - ILRI	r.ilri.n.kenet.or.ke
International Livestock Research Institute - ILRI Kapiti	r.ilri-kapiti.n.kenet.or.ke
Jaffery Academy Mombasa	r.jaffery-msa.s.kenet.or.ke
Jaffery Nairobi	r.jaffery-nrb.n.kenet.or.ke
Jaramogi Oginga Odinga University of Science and Technology - JOOUST	r.jooust-main.k.kenet.or.ke
JKUAT Karen	r.jkuat-karen.n.kenet.or.ke
Jomo Kenyatta University-CBD	r.jkuat-town.n.kenet.or.ke
Jomo Kenyatta University-Eldoret	r.jkuat-eld.e.kenet.or.ke
Jomo Kenyatta University-Kisii	r.jkuat-kisii.k.kenet.or.ke
Jomo Kenyatta University-Kitale	r.jkuat-kitale.e.kenet.or.ke
Jomo Kenyatta University-Main	r.jkuat-main.n.kenet.or.ke
Jomo Kenyatta University-Mombasa	r.jkuat-msa.s.kenet.or.ke
Jomo Kenyatta University-Nakuru	r.jkuat-nakuru.a.kenet.or.ke
Jumuia Hosptial	r.jumuia-hosp.k.kenet.or.ke
Kabarak University Main Campus	r.kab-main.a.kenet.or.ke
Kabarak University Town Campus	r.kab-town.a.kenet.or.ke
Kaiboi Technical Training Institute	r.kaiboi-tti.e.kenet.or.ke
Kaimosi Friends Theological College	r.kaimosi-ftc.k.kenet.or.ke
Kaimosi TTC	r.kaimosi-ttc.k.kenet.or.ke
Kajiado West Technical and Vocational College	r.kajiado-west-tvc.n.kenet.or.ke
Kamukunji Technical and Vocational College	r.kamukunji-tvc.n.kenet.or.ke
Karatina University - Main Campus	r.karatina-main.m.kenet.or.ke
Karatina University - Town Campus	r.karatina-town.m.kenet.or.ke
Karen Technical training for the  deaf	r.karen-ttid.n.kenet.or.ke
Karumo Technical Training College	r.karumo-tti.m.kenet.or.ke
Katine Technical Training Institute	r.katine-tti.n.kenet.or.ke
KCA University -Kisumu	r.kca-ksm.k.kenet.or.ke
KCA University -Kitengela Campus	r.kca-kitengela.n.kenet.or.ke
KCA University -Main	r.kca-main.n.kenet.or.ke
KCA University -Monrovia Campus	r.kca-monrovia.n.kenet.or.ke
KEFRI Garissa	r.kefri-garissa.n.kenet.or.ke
KEFRI Gede	r.kefri-gede.s.kenet.or.ke
KEFRI HQ Muguga	r.kefri-muguga.n.kenet.or.ke
KEFRI Kakamega	r.kefri-kkm.k.kenet.or.ke
KEFRI Karura	r.kefri-karura.n.kenet.or.ke
KEFRI Kibwezi	r.kefri-kibwezi.n.kenet.or.ke
KEFRI Kitui	r.kefri-kitui.n.kenet.or.ke
KEFRI Lamu	r.kefri-lamu.s.kenet.or.ke
KEFRI Lodwar	r.kefri-lodwar.e.kenet.or.ke
KEFRI Marigat	r.kefri-marigat.a.kenet.or.ke
KEFRI Maseno	r.kefri-maseno.k.kenet.or.ke
KEFRI Turbo	r.kefri-turbo.n.kenet.or.ke
KEMRI Alupe	r.kemri-alupe.k.kenet.or.ke
KEMRI CPH	r.kemri-cph.n.kenet.or.ke
KEMRI Graduate School + Mbagathi	r.kemri-grad.n.kenet.or.ke
KEMRI HQ	r.kemri-hq.n.kenet.or.ke
KEMRI Kirinyaga	r.kemri-kirinyaga.m.kenet.or.ke
KEMRI Kisian	r.kemri-kisian.k.kenet.or.ke
KEMRI Malindi	r.kemri-malindi.s.kenet.or.ke
KEMRI Mtwapa	r.kemri-mtwapa.s.kenet.or.ke
KEMRI-Kwale	r.kemri-kwale.s.kenet.or.ke
Kenya accountant and secretaries (KASNEB)	r.kasneb.n.kenet.or.ke
Kenya Coast National Polytechnic	r.kenya-coast-poly.s.kenet.or.ke
Kenya Education Management Institute - KEMI	r.kemi-hq.n.kenet.or.ke
Kenya Forestry Research Institute Londiani	r.kefri-londiani.a.kenet.or.ke
Kenya Forestry Research Institute Migori	r.kefri-migori.k.kenet.or.ke
Kenya Forestry Research Institute Nyeri	r.kefri-nyeri.m.kenet.or.ke
Kenya Forestry Research Institute Rumuruti	r.kefri-rumuruti.a.kenet.or.ke
Kenya Forestry Research Institute Taita/wudanyi	r.kefri-wundanyi.s.kenet.or.ke
Kenya Highlands University	r.khu.a.kenet.or.ke
Kenya Industrial Research and Development Institute (KIRDI)	r.kirdi-southc.n.kenet.or.ke
Kenya Industrial Research and Development Institute (KIRDI) - KSM	r.kirdi-ksm.k.kenet.or.ke
Kenya Insitute of Special Education - KISE	r.kise.n.kenet.or.ke
Kenya Institute of Curriculum Development (KICD)	r.kicd.n.kenet.or.ke
Kenya Institute Of Highways & Building Technology - KIHBT Commercial	r.kihbt-commercial-street.n.kenet.or.ke
Kenya Institute Of Highways & Building Technology - KIHBT Enterprise Rd	r.kihbt-enterprise.n.kenet.or.ke
Kenya Institute Of Highways & Building Technology - KIHBT Kibiko	r.kihbt-ngong-kibiko.n.kenet.or.ke
Kenya Institute Of Highways & Building Technology - KIHBT Kisii	r.kihbt-kisii.k.kenet.or.ke
Kenya Institute Of Highways & Building Technology - KIHBT Ngong town	r.kihbt-ngong.n.kenet.or.ke
Kenya Institute of Mass Communication - KIMC Eldoret	r.kimc-eld.e.kenet.or.ke
Kenya Institute of Mass Communication - KIMC Main	r.kimc-sb.n.kenet.or.ke
Kenya Marine and Fisheries Research Institute-Baringo	r.kmfri-baringo.a.kenet.or.ke
Kenya Marine and Fisheries Research Institute-Gazi	r.kmfri-gazi.s.kenet.or.ke
Kenya Marine and Fisheries Research Institute-Kegati	r.kmfri-kegati.k.kenet.or.ke
Kenya Marine and Fisheries Research Institute-Kisumu	r.kmfri-ksm.k.kenet.or.ke
Kenya Marine and Fisheries Research Institute-Mombasa	r.kmfri-msa.s.kenet.or.ke
Kenya Marine and Fisheries Research Institute-Nairobi	r.kmfri-nrb.n.kenet.or.ke
Kenya Marine and Fisheries Research Institute-Naivasha	r.kmfri-naiv.a.kenet.or.ke
Kenya Marine and Fisheries Research Institute-Sagana	r.kmfri-sagana.m.kenet.or.ke
Kenya Marine and Fisheries Research Institute-Sangoro	r.kmfri-sangoro.k.kenet.or.ke
Kenya Marine and Fisheries Research Institute-Shimoni	r.kmfri-shimoni.s.kenet.or.ke
Kenya Marine and Fisheries Research Institute-Turkana	r.kmfri-turkana.e.kenet.or.ke
Kenya Medical Training College Awendo	r.kmtc-awendo.k.kenet.or.ke
Kenya Medical Training College Bomet	r.kmtc-bomet.a.kenet.or.ke
Kenya Medical Training College Bondo	r.kmtc-bondo.k.kenet.or.ke
Kenya Medical Training College Bungoma	r.kmtc-bungoma.e.kenet.or.ke
Kenya Medical Training College Busia	r.kmtc-busia.k.kenet.or.ke
Kenya Medical Training College Chemolingot	r.kmtc-chemolingot.e.kenet.or.ke
Kenya Medical Training College Chuka	r.kmtc-chuka.m.kenet.or.ke
Kenya Medical Training College Chwele	r.kmtc-chwele.e.kenet.or.ke
Kenya Medical Training College Eldoret	r.kmtc-eld.e.kenet.or.ke
Kenya Medical Training College Embu	r.kmtc-embu.m.kenet.or.ke
Kenya Medical Training College Garissa	r.kmtc-garissa.n.kenet.or.ke
Kenya Medical Training College Homabay	r.kmtc-homabay.k.kenet.or.ke
Kenya Medical Training College Imenti	r.kmtc-imenti.m.kenet.or.ke
Kenya Medical Training College Isiolo	r.kmtc-isiolo.m.kenet.or.ke
Kenya Medical Training College Iten	r.kmtc-iten.e.kenet.or.ke
Kenya Medical Training College Kabarnet	r.kmtc-kabarnet.e.kenet.or.ke
Kenya Medical Training College Kangundo	r.kmtc-kangundo.n.kenet.or.ke
Kenya Medical Training College Kapenguria	r.kmtc-kapenguria.e.kenet.or.ke
Kenya Medical Training College Kapkatet	r.kmtc-kapkatet.a.kenet.or.ke
Kenya Medical Training College Kaptumo	r.kmtc-kaptumo.e.kenet.or.ke
Kenya Medical Training College Karen Campus	r.kmtc-karen.n.kenet.or.ke
Kenya Medical Training College Karuri	r.kmtc-karuri.n.kenet.or.ke
Kenya Medical Training College Kilifi	r.kmtc-kilifi.s.kenet.or.ke
Kenya Medical Training College Kisii	r.kmtc-kisii.k.kenet.or.ke
Kenya Medical Training College Kisumu	r.kmtc-ksm.k.kenet.or.ke
Kenya Medical Training College Kitale	r.kmtc-kitale.e.kenet.or.ke
Kenya Medical Training College Kitui	r.kmtc-kitui.n.kenet.or.ke
Kenya Medical Training College Kombewa	r.kmtc-kombewa.k.kenet.or.ke
Kenya Medical Training College Kuria	r.kmtc-kuria.k.kenet.or.ke
Kenya Medical Training College Kwale	r.kmtc-kwale.s.kenet.or.ke
Kenya Medical Training College Lake Victoria	r.kmtc-lvictoria.k.kenet.or.ke
Kenya Medical Training College Lamu	r.kmtc-lamu.s.kenet.or.ke
Kenya Medical Training College Lodwar	r.kmtc-lodwar.e.kenet.or.ke
Kenya Medical Training College Lugari	r.kmtc-lugari.e.kenet.or.ke
Kenya Medical Training College Machakos	r.kmtc-macha.n.kenet.or.ke
Kenya Medical Training College Makindu	r.kmtc-makindu.n.kenet.or.ke
Kenya Medical Training College Makueni	r.kmtc-makueni.n.kenet.or.ke
Kenya Medical Training College Mandera	r.kmtc-mandera.n.kenet.or.ke
Kenya Medical Training College Manza	r.kmtc-manza.n.kenet.or.ke
Kenya Medical Training College Masita	r.kmtc-masita.k.kenet.or.ke
Kenya Medical Training College Mathare	r.kmtc-mathare.n.kenet.or.ke
Kenya Medical Training College Maua	r.kmtc-maua.m.kenet.or.ke
Kenya Medical Training College Mbooni	r.kmtc-mbooni.n.kenet.or.ke
Kenya Medical Training College Mbuvo	r.kmtc-mbuvo.n.kenet.or.ke
Kenya Medical Training College Meru	r.kmtc-meru.m.kenet.or.ke
Kenya Medical Training College Miathene	r.kmtc-miathene.m.kenet.or.ke
Kenya Medical Training College Migori	r.kmtc-migori.k.kenet.or.ke
Kenya Medical Training College Molo	r.kmtc-molo.a.kenet.or.ke
Kenya Medical Training College Mombasa	r.kmtc-msa.s.kenet.or.ke
Kenya Medical Training College Mosoriot	r.kmtc-mosoriot.e.kenet.or.ke
Kenya Medical Training College Msambweni	r.kmtc-msambweni.s.kenet.or.ke
Kenya Medical Training College Mumias	r.kmtc-mumias.k.kenet.or.ke
Kenya Medical Training College Murang'a	r.kmtc-muranga.m.kenet.or.ke
Kenya Medical Training College Mwingi	r.kmtc-mwingi.n.kenet.or.ke
Kenya Medical Training College Nairobi	r.kmtc.n.kenet.or.ke
Kenya Medical Training College Nakuru	r.kmtc-nakuru.a.kenet.or.ke
Kenya Medical Training College Navakholo	r.kmtc-navakholo.k.kenet.or.ke
Kenya Medical Training College Nyahururu	r.kmtc-nyahururu.a.kenet.or.ke
Kenya Medical Training College Nyamache	r.kmtc-nyamache.k.kenet.or.ke
Kenya Medical Training College Nyamira	r.kmtc-nyamira.k.kenet.or.ke
Kenya Medical Training College Nyandarua	r.kmtc-nyandarua.a.kenet.or.ke
Kenya Medical Training College Nyeri	r.kmtc-nyeri.m.kenet.or.ke
Kenya Medical Training College Oloitoktok	r.kmtc-oloitokitok.n.kenet.or.ke
Kenya Medical Training College Othaya	r.kmtc-othaya.m.kenet.or.ke
Kenya Medical Training College Port Reitz	r.kmtc-port-reitz.s.kenet.or.ke
Kenya Medical Training College Rachuonyo	r.kmtc-rachuonyo.k.kenet.or.ke
Kenya Medical Training College Rera	r.kmtc-rera.k.kenet.or.ke
Kenya Medical Training College Siaya	r.kmtc-siaya.k.kenet.or.ke
Kenya Medical Training College Sigowet	r.kmtc-sigowet.a.kenet.or.ke
Kenya Medical Training College Tana River	r.kmtc-tana-river.s.kenet.or.ke
Kenya Medical Training College Taveta	r.kmtc-taveta.s.kenet.or.ke
Kenya Medical Training College Teso	r.kmtc-teso.k.kenet.or.ke
Kenya Medical Training College Thika	r.kmtc-thika.n.kenet.or.ke
Kenya Medical Training College Transmara	r.kmtc-transmara.a.kenet.or.ke
Kenya Medical Training College Ugenya	r.kmtc-ugenya.k.kenet.or.ke
Kenya Medical Training College Ugunja	r.kmtc-ugunja.k.kenet.or.ke
Kenya Medical Training College Vihiga	r.kmtc-vihiga.k.kenet.or.ke
Kenya Medical Training College Voi	r.kmtc-voi.s.kenet.or.ke
Kenya Medical Training College Wajir	r.kmtc-wajir.n.kenet.or.ke
Kenya Medical Training College Webuye	r.kmtc-webuye.k.kenet.or.ke
Kenya Military academy -Former NDU now KMA	r.kma.a.kenet.or.ke
Kenya National Examinations Council - Caledonia/Mitihani Hse	r.knec-mitihanihse.n.kenet.or.ke
Kenya National Examinations Council - Headquarters	r.knec-hq.n.kenet.or.ke
Kenya National Qualifications Authority	r.knqa.n.kenet.or.ke
Kenya School of Government Embu	r.ksg-embu.m.kenet.or.ke
Kenya School of Government Matuga	r.ksg-matuga.s.kenet.or.ke
Kenya School of Government Mombasa	r.ksg-msa.s.kenet.or.ke
Kenya School of Law Karen	r.ksl-karen.n.kenet.or.ke
Kenya School of Law Town	r.ksl-town.n.kenet.or.ke
Kenya space Agency	r.ksa.n.kenet.or.ke
Kenya Technical Trainers College	r.kttc.n.kenet.or.ke
Kenya Universities and Colleges Central Placement Service - KUCCPS	r.kuccps.n.kenet.or.ke
Kenya Utalii college	r.utalii-college.n.kenet.or.ke
Kenya Veterinary Vaccines Production Institute - KEVEVAPI HQ	r.kevevapi-hq.n.kenet.or.ke
Kenya Veterinary Vaccines Production Institute - KEVEVAPI Upper Kabete	r.kevevapi.n.kenet.or.ke
Kenya Water Institute-Chiakariga	r.kewi-chiakariga.m.kenet.or.ke
Kenya Water Institute-HQ	r.kewi-hq.n.kenet.or.ke
Kenya Water Institute-Indstrial Area	r.kewi-industrial.n.kenet.or.ke
Kenya Water Institute-Kisumu	r.kewi-ksm.k.kenet.or.ke
Kenya Water Institute-Kitui	r.kewi-kitui.n.kenet.or.ke
Kenya Wildlife Service - KWS HQ	r.kws-hq.n.kenet.or.ke
Kenyatta University Teaching and Referral Hospital - Main	r.ku-hosp.n.kenet.or.ke
Kenyatta University-City	r.ku-city.n.kenet.or.ke
Kenyatta University-Kitui	r.ku-kitui.n.kenet.or.ke
Kenyatta University-Main	r.ku-main.n.kenet.or.ke
Kenyatta University-Mombasa	r.ku-msa.s.kenet.or.ke
Kenyatta University-Nakuru	r.ku-nakuru.a.kenet.or.ke
Kenyatta University-North Coast	r.ku-north-coast.s.kenet.or.ke
Kenyatta University-Parklands	r.ku-parklands.n.kenet.or.ke
Kenyatta University-Ruiru	r.ku-ruiru.n.kenet.or.ke
Kenyenya Teachers Training College	r.kenyenya-ttc.k.kenet.or.ke
Kericho Township Technical and Vocational College	r.kericho-west-tvc.a.kenet.or.ke
Keroka Technical Training Institute	r.keroka-tti.k.kenet.or.ke
Kibabii Diploma Teachers College Syombe	r.kibabii-ttc-syombe.e.kenet.or.ke
Kibabii Diploma Teachers College Tuuti Campus	r.kibabii-ttc-tuuti.e.kenet.or.ke
Kibabii University	r.kibabii.e.kenet.or.ke
Kipchoge University	r.kipchoge.test.or.ke
Kisii National Polytechnic	r.kisii-poly.k.kenet.or.ke
Kisii University Eldoret	r.kisii-eld.e.kenet.or.ke
Kisii University Kericho	r.kisii-kericho.a.kenet.or.ke
Kisii University Migori	r.kisii-migori.k.kenet.or.ke
Kisii University Nairobi	r.kisii-nrb.n.kenet.or.ke
KIST - Kiambu Insitute of Science & Technology	r.kist.n.kenet.or.ke
Kisumu Polytechnic	r.ksm-poly.k.kenet.or.ke
Kitale National Polytechnic	r.kitale-poly.e.kenet.or.ke
Laikipia University	r.luc.a.kenet.or.ke
Lawson School	r.lawson-sch.n.kenet.or.ke
Limuru Technical and Vocational College	r.limuru-tvc.n.kenet.or.ke
Livingroom Hospital Main	r.livingroom-int.e.kenet.or.ke
Livingroom International Kipkaren Hospital	r.livingroom-int-kipkaren.e.kenet.or.ke
Lugari Diploma Teachers Training College	r.lugari-dip-ttc.e.kenet.or.ke
Lukenya University	r.lukenya.n.kenet.or.ke
Luora TTI	r.luora-tti.test.or.ke
Maasai Mara University	r.narok.a.kenet.or.ke
Machakos Teachers Training College	r.machakos-ttc.n.kenet.or.ke
Machakos TTI for Blind	r.macha-blind.n.kenet.or.ke
Machakos University	r.macha.n.kenet.or.ke
Mama Ngina University College	r.mama-ngina.n.kenet.or.ke
Masai Technical Training Institute	r.masai-tti.n.kenet.or.ke
Masinde Muliro University	r.mmust.k.kenet.or.ke
Meru National Polytechnic	r.meru-poly.m.kenet.or.ke
Meru Teaching and Referral Hospital	r.meru-trh.m.kenet.or.ke
Meru University -Marimba Centre	r.must-marimba.m.kenet.or.ke
Meru University -Meru Town Campus	r.must-town.m.kenet.or.ke
Meru University of Science & Technology - Main	r.mucst.m.kenet.or.ke
Mitunguu Technical Training Institute	r.mitunguu-tti.m.kenet.or.ke
Moi Teaching and Referral Hospital - MTRH	r.mtrh.e.kenet.or.ke
Moi University - CHS	r.moi-chs.e.kenet.or.ke
Moi University - Main Campus	r.moi-main.e.kenet.or.ke
Moi University - Mombasa Campus	r.moi-msa.s.kenet.or.ke
Moi University - Nairobi Campus	r.moi-nrb.n.kenet.or.ke
Moi University - Pension Scheme	r.moi-pension.e.kenet.or.ke
Moi University - School of Law	r.moi-sol.e.kenet.or.ke
Moringa School	r.moringa.n.kenet.or.ke
Mosoriot TTC	r.mosoriot-ttc.e.kenet.or.ke
Mount Kenya University - Mombasa	r.mku-msa.s.kenet.or.ke
Mount Kenya University- Eldoret	r.mku-eld.e.kenet.or.ke
Mount Kenya University-Kitale Campus	r.mku-kitale.e.kenet.or.ke
Mount Kenya University-Meru Campus	r.mku-meru.m.kenet.or.ke
Mount Kenya University-Nairobi CBD	r.mku-nrb.n.kenet.or.ke
Mount Kenya University-Nakuru	r.mku-nakuru.a.kenet.or.ke
Mount Kenya University-Parklands	r.mku-parklands.n.kenet.or.ke
Mount Kenya University-Thika Campus	r.mku-main.n.kenet.or.ke
Mpala Research Centre	r.mpala.m.kenet.or.ke
MUCHS-USAID 4TheChild Formerly AMPATH-Kisumu	r.ampath-ksm.k.kenet.or.ke
Mukiria Technical Training Institute	r.mukiria-tti.m.kenet.or.ke
Multi Media University	r.mmu.n.kenet.or.ke
Muraga Technical Training Institute	r.muraga-tti.m.kenet.or.ke
Murang'a University of Technology - Mareira Campus	r.mut-mariira.m.kenet.or.ke
Muranga Technical Training Institute	r.muranga-tti.m.kenet.or.ke
Muranga University	r.mruc.m.kenet.or.ke
Nairobi Technical Training Instituition	r.nairobi-tti.n.kenet.or.ke
Narok Teachers Training College	r.narok-ttc.a.kenet.or.ke
National Commission For Science, Technology & Innovation - NACOSTI	r.nacosti.n.kenet.or.ke
National Defence Staff College	r.ndc.n.kenet.or.ke
National Defence University	r.ndu-main.a.kenet.or.ke
National Intelligence Research University College	r.niruc.n.kenet.or.ke
National Museums of Kenya	r.nmk.n.kenet.or.ke
National Museums of Kenya - Karen	r.nmk-karen.n.kenet.or.ke
National Research Fund	r.nrf.n.kenet.or.ke
Ngong Technical and Vocational college	r.ngong-tvc.n.kenet.or.ke
NI3C - Part of CEMASTEA	r.ni3c.n.kenet.or.ke
Nkabune TTI	r.nkabune-tti.m.kenet.or.ke
North Eastern National Polytechnic	r.ne-poly.n.kenet.or.ke
Nuu TVC	r.nuu-tvc.n.kenet.or.ke
Nyandarua Institute	r.nyandarua-poly.m.kenet.or.ke
Nyeri National Polytechnic	r.nyeri-poly.m.kenet.or.ke
Omuga Technical and Vocational College	r.omuga-tvc.k.kenet.or.ke
Outspan Medical College	r.outspan-mc.m.kenet.or.ke
Outspan Medical Hospital	r.outspan-hosp.m.kenet.or.ke
PAC University	r.pac.n.kenet.or.ke
PAC Valley Road	r.pac-valley-rd.n.kenet.or.ke
PAUISTI	r.pausti.n.kenet.or.ke
PC Kinyanjui	r.pc-kinyanjui.n.kenet.or.ke
PCEA Chogoria	r.pcea-chogoria-hsp.m.kenet.or.ke
PCEA Kikuyu Hospital Nursing School	r.pcea-kikuyu-hosp.n.kenet.or.ke
Pioneer International University	r.piu-main.n.kenet.or.ke
Presbyterian University of Eastern Africa - PUEA	r.puea-kikuyu.n.kenet.or.ke
Pwani University Mombasa	r.pwani-msa.s.kenet.or.ke
Pwani University-On Session (Sep-Mar 2023)	r.pwani.s.kenet.or.ke
Qwetu Acorn House HQ	r.qwetu-hq.n.kenet.or.ke
Qwetu CUEA	r.qwetu-cuea.kenet.or.ke
Qwetu Jogoo	r.qwetu-jogoo.n.kenet.or.ke
Qwetu Wilson	r.qwetu-wilson.n.kenet.or.ke
RAF University - Main (Islamic University of Kenya)	r.raf.n.kenet.or.ke
RAF University - South C (Islamic University of Kenya)	r.raf-southc.n.kenet.or.ke
Ramogi Institute of Advanced Technology	r.ramogi-inst.k.kenet.or.ke
Regional Centre for Mapping Resource For Development (RCMRD)	r.rcmrd.n.kenet.or.ke
Riara University	r.riara.n.kenet.or.ke
Rift Valley Technical Training Institute	r.rv-tti.e.kenet.or.ke
Rongo University	r.rongo.k.kenet.or.ke
School Equipment Production Unit (SEPU)	r.sepu.n.kenet.or.ke
Scott Christian University	r.scott.n.kenet.or.ke
Shanzu TTC	r.shanzu-ttc.s.kenet.or.ke
Siala Technical Training Institute	r.siala-tti.k.kenet.or.ke
Siaya Institute of technology	r.siaya-inst.k.kenet.or.ke
Sigalagala Polytechnic	r.sigalagala.k.kenet.or.ke
Sikri Technical Training Institute	r.sikri-tti.k.kenet.or.ke
Siruti Technical and Vocational College Awendo	r.siruti-tvc.k.kenet.or.ke
South Eastern University -Main	r.seku.n.kenet.or.ke
South Eastern University -Wote	r.seku-wote.n.kenet.or.ke
Sr. Leonella Consolata Medical College	r.consolata-mc.m.kenet.or.ke
St Paul Miluki Secondary School	r.st-pauls-miluki.e.kenet.or.ke
St. Joseph Technical Training Institute for the Deaf Nyangoma	r.st-joseph-tti.k.kenet.or.ke
St. Paul University - Nairobi CBD	r.spu-tc.n.kenet.or.ke
St. Paul's University - Limuru - Main	r.spu-main.n.kenet.or.ke
St. Paul's University - Nakuru	r.spu-nakuru.a.kenet.or.ke
Strathmore University	r.strath.n.kenet.or.ke
Taita Taveta Univeristy Ngerenyi	r.taita-ngerenyi.s.kenet.or.ke
Taita Taveta University	r.taita.s.kenet.or.ke
Tangaza University College	r.tangaza.n.kenet.or.ke
Technical And Vocational Education and Training Authority (TVETA)	r.tveta.n.kenet.or.ke
Technical And Vocational Education and Training Authority (TVETA) -Elodret	r.tveta-eldoret.e.kenet.or.ke
Technical And Vocational Education and Training Authority (TVETA) -Kisumu	r.tveta-kisumu.k.kenet.or.ke
Technical And Vocational Education and Training Authority (TVETA) -Mombasa	r.tveta-msa.s.kenet.or.ke
Technical University of Kenya	r.tuk-main.n.kenet.or.ke
Technical University of Mombasa-Kwale	r.tum-kwale.s.kenet.or.ke
Technical University of Mombasa-Lamu	r.tum-lamu.s.kenet.or.ke
Tenwek Hospital	r.tenwek-main.a.kenet.or.ke
Tenwek Kabason	r.tenwek-kaboson.a.kenet.or.ke
Tenwek Ngito	r.tenwek-ngito.a.kenet.or.ke
Tharaka University	r.tharaka.m.kenet.or.ke
The Co-operative University - Karen	r.coop-karen.n.kenet.or.ke
The Co-operative University - Nairobi	r.coop-nrb.n.kenet.or.ke
The East African University (TEAU)	r.teau.n.kenet.or.ke
The World Agroforestry Centre (ICRAF)	r.icraf.n.kenet.or.ke
Thika TTI Main	r.thika-tti-main.n.kenet.or.ke
Thogoto Teachers Training college	r.thogoto-ttc.n.kenet.or.ke
Tourism Regulatory Authority-Eldoret	r.tra-eld.e.kenet.or.ke
Tourism Regulatory Authority-HQ	r.tra-hq.n.kenet.or.ke
Tourism Regulatory Authority-Kisumu	r.tra-ksm.k.kenet.or.ke
Tourism Regulatory Authority-Malindi	r.tra-malindi.s.kenet.or.ke
Tourism Regulatory Authority-Mombasa	r.tra-msa.s.kenet.or.ke
Tourism Regulatory Authority-Nakuru	r.tra-nakuru.a.kenet.or.ke
Tourism Regulatory Authority-Nyeri	r.tra-nyeri.m.kenet.or.ke
Tourism Research Institute	r.tri.n.kenet.or.ke
Tseikuru Technical Training Institute	r.tseikuru-tti.n.kenet.or.ke
Turbo TVC	r.turbo-tvc.e.kenet.or.ke
Turkana University College	r.turkana.e.kenet.or.ke
TVET-CDACC	r.tvet-cdacc.n.kenet.or.ke
Umma Liason Office	r.umma-liaison-office.n.kenet.or.ke
Umma University TVET institute/Umma Thika	r.umma-thika.n.kenet.or.ke
Umma University-Garissa Campus	r.umma-garissa.n.kenet.or.ke
Umma University-Kajiado Campus	r.umma-kajiado.n.kenet.or.ke
United States International University -Africa	r.usiu.n.kenet.or.ke
University of EA - Baraton	r.ueab-main.e.kenet.or.ke
University of Eldoret - Eldoret campus	r.uoe-eld-town.e.kenet.or.ke
University of Eldoret - Main	r.chep.e.kenet.or.ke
University of Eldoret - Nairobi	r.uoe-nrb.n.kenet.or.ke
University of Kabianga  - Kapkatet	r.kabianga-kapkatet.a.kenet.or.ke
University of Kabianga  - Main	r.kabianga.a.kenet.or.ke
University of Kabianga  - Sotik	r.kabianga-sotik.a.kenet.or.ke
University of Kabianga  -Kericho	r.kabianga-kericho.a.kenet.or.ke
UON Upper Kabete	r.uon-ukabete.n.kenet.or.ke
UON VC	r.uon-vc.n.kenet.or.ke
Wote TTI	r.wote-tti.n.kenet.or.ke
Zetech Main	r.zetech-main.n.kenet.or.ke
Zetech Mangu	r.zetech-mangu.n.kenet.or.ke
Zetech Pioneer	r.zetech-pioneer.n.kenet.or.ke
Zetech Stanbank	r.zetech-stanbank.n.kenet.or.ke
[Wildlife Research & Training Inst] Kenya Wildlife Service Training Institute - KWSTI	r.kwsti-naiv.a.kenet.or.ke
